################
#      #G#     #
#              #
#           @  #
#       s      #
#     s       V#
###   c      ###
#L    s  s    G#
###          ###
#              #
#        c     #
#              #
#     V       X#
#              #
#     #L#      #
################
