################
#     @        #
# LLLLLLLLLLLL #
# GGGGGGGGGGGG #
#  ##########  #
#      #X#     #
#              #
#              #
#              #
###    ##    ###
#DDDDDDDDDDDDDD#
#SS###SSS####SS#
#SS#CCCCCCCS#SS#
#SS##########SS#
#SSSSSSSSSSSSSS#
################
